0,0,0,0,0,0,0,0,0,0,0,0,0,0,0,0,0,0,0,0,0,0,0,0,0,0,0,0,0,0,0,0,0,0,0,0,0,0,0
0,1,1,0,0,0,0,0,1,1,1,0,0,0,0,0,0,0,0,0,0,0,0,0,0,0,0,0,0,0,0,0,0,0,0,0,0,0,0
0,1,1,1,0,0,1,1,9,0,1,9,1,0,1,1,0,1,9,1,0,1,0,0,0,0,0,0,0,0,0,0,0,0,0,0,0,0,0
0,0,1,1,1,1,1,2,2,2,2,2,1,1,1,1,1,1,1,1,1,1,1,1,0,0,0,0,0,0,0,0,0,0,0,0,0,0,0
0,0,0,1,1,1,1,3,1,9,1,2,1,1,1,1,9,1,1,1,1,1,1,1,1,0,2,2,2,2,2,2,2,0,0,0,0,0,0
0,0,0,2,2,2,2,2,1,1,1,2,1,1,1,1,1,1,1,1,1,1,9,1,1,1,2,1,1,1,1,1,2,0,0,0,0,0,0
0,0,0,2,1,1,1,2,2,1,2,2,2,2,2,2,2,2,1,1,1,1,1,1,1,1,3,1,1,2,6,1,2,0,0,0,0,0,0
0,2,2,2,1,6,9,1,1,1,9,1,1,1,1,9,1,2,1,1,1,1,1,9,1,1,2,2,2,2,2,1,2,0,0,0,0,0,0
0,0,0,2,1,1,1,2,2,1,2,2,2,2,2,2,1,2,1,1,9,1,1,1,1,1,3,1,1,2,1,1,2,0,0,0,0,0,0
0,0,0,2,2,2,2,2,1,9,1,2,1,1,1,2,1,2,0,1,1,1,1,1,1,1,2,1,1,1,1,1,2,0,0,0,0,0,0
0,0,0,0,0,0,0,2,1,1,1,2,1,9,1,2,1,2,0,0,0,0,0,1,1,0,2,2,2,2,2,2,2,0,0,0,0,0,0
0,0,0,0,0,0,0,2,1,1,1,1,1,1,1,2,1,2,0,0,0,0,0,0,0,0,0,0,0,0,0,0,0,0,0,0,0,0,0
0,0,0,0,0,0,0,2,2,2,2,2,2,2,2,2,3,2,2,2,0,0,0,0,2,2,2,2,2,2,2,2,2,2,0,0,0,0,0
0,0,0,0,0,0,0,0,0,0,2,1,1,1,2,1,1,1,1,2,2,2,2,2,2,1,1,1,1,2,2,1,1,2,0,0,0,0,0
2,2,2,2,0,0,0,0,0,0,2,1,6,1,2,1,1,9,1,1,1,1,9,1,1,1,1,1,1,1,1,9,1,2,0,0,0,0,0
2,1,1,2,2,2,2,0,0,0,2,1,1,1,1,1,1,1,1,2,2,2,2,2,2,1,1,1,9,2,2,2,1,2,0,0,0,0,0
2,6,1,1,1,1,2,2,2,2,2,2,2,1,2,2,2,2,2,2,0,0,0,0,2,2,2,2,1,2,6,3,1,2,2,2,2,2,2
2,2,2,2,9,1,2,2,1,1,2,2,2,1,2,2,1,1,1,2,0,0,0,0,0,0,2,2,1,2,2,2,1,1,1,2,2,1,2
0,0,0,2,1,1,1,1,1,1,1,9,1,1,3,1,1,1,1,2,0,0,0,0,0,0,2,1,1,1,1,1,1,1,9,1,1,1,2
0,0,0,2,1,1,2,2,2,2,2,2,2,2,2,2,1,1,6,2,0,0,0,0,0,0,2,1,1,9,2,2,2,2,2,2,2,9,2
0,0,0,2,2,2,2,0,0,0,0,0,0,0,0,2,1,2,2,2,0,0,0,0,0,0,2,2,2,2,2,0,0,0,0,0,2,1,2
0,0,2,2,2,2,2,2,0,0,2,2,2,2,2,2,1,2,2,0,0,0,0,0,0,0,0,0,0,0,0,0,0,0,0,2,2,1,2
0,0,2,1,1,1,1,2,2,2,2,1,1,1,2,1,1,1,2,0,0,0,0,1,1,1,1,1,1,1,1,9,1,1,1,3,1,1,2
0,0,2,6,1,1,1,1,1,1,1,1,9,1,1,1,1,9,2,0,0,0,0,1,0,0,0,0,0,0,0,0,0,0,0,2,6,1,2
0,0,2,1,9,1,1,2,2,1,2,1,1,1,2,1,1,1,2,0,0,0,0,1,0,0,0,0,0,0,0,0,0,0,0,2,2,2,2
0,0,2,2,2,2,2,2,2,1,2,2,2,2,2,2,2,3,2,0,0,0,0,1,0,0,0,0,0,0,0,0,0,0,0,0,0,0,0
0,0,0,0,0,0,0,0,2,1,1,1,2,2,2,1,6,A,2,0,0,1,1,1,0,0,0,0,0,0,0,0,0,0,0,0,0,0,0
0,0,0,0,0,0,0,0,2,1,1,1,2,2,2,1,D,6,4,5,1,1,0,0,0,0,0,0,0,0,0,0,0,0,0,0,0,0,0
0,0,0,0,0,0,0,0,2,6,1,9,2,2,2,1,1,1,2,0,0,0,0,0,0,0,0,0,0,0,0,0,0,0,0,0,0,0,0
0,0,0,0,0,0,0,0,2,2,2,2,2,2,2,2,2,2,2,0,0,0,0,0,0,0,0,0,0,0,0,0,0,0,0,0,0,0,0